000000000000000000000000000000000000000000000000000000000000000000000000000000000
100000000000000000000000000000000000011111000000000000000000000000000000000000000
130000000000000000000020000000001111000000000300000000000000003000011111110000000
111111111111111111111110000000000000000000000000000000000000011111000000000000000
100000000000000000000000000000000002000000300000000000000000000000000000000000000
100000000000000000000000000000000411111111111111111111111111111000000000000000000
111111111111111100011100001111111111111111111111111111111111111111100011111000115
